S__________________
_########_________E
___#_#######__#####
_#_#________##_____
________##_______#_
_#_#________##_____
________##_______#_
_#_#________##_____
________##_______#_
_#_#________##_____
________##_______#_
